NO ./sprites/mur/mur4.xpm
SO ./sprites/mur/mur4.xpm
WE ./sprites/mur/mur4.xpm
EA ./sprites/mur/mur4.xpm

F ./sprites/sol/sol18.xpm
C ./sprites/sol/sol18.xpm

1111111111111111111111111111111111111111
1m00000000000000000n00000000000000000001
1000000000n00000000s00000000000000000001
10000n00000000000000000000000n00000000n1
10000011111111111111111111111111110000011111111111111111111
1000001                          10000010000m000000n0000001
1000001                          10000020000000000000000001
1000n01                          10000011111111111111100001
10000011111111111111111111111111110000s1             1s0001
10000s0000000000000000000000000000000001             100001
1000000000000000000000000000n00000000001             100001
1000000000000000000000000000000000000001             100001
10000000000000000000000000000000000000n1             100001
100000000n000000000000000000000000000001             100001
10000000000000000000000000s0000000000001             1000n1
10000s0000000000000000000000000000000001             100001
10000000000n0000000000000000000000000001             100001
1111111111111121111111111111111111111111             100001
            10001                                    100001
            10s01                                    100s01
            10001                                    100001
            10001                                    100001
            10001                                    100001
            10001                                    100001
            10001                                    100001
    11111111112111111111111111111                    100001
    1000000n000000000000000000001                    100n01
    1000000000010000000000000000111111111111111111111100n0111111111111111111111111111111111
    1000000s0000000000000000000001000000000002000000000000100n00000000010000000001000000001
    1000000000000000100000000000000000000000010000000n00000000000000000000010000000000000W1
    111111111111111111111111111111111111111111111111111111111111111111111111111111111111111
