
NO ./sprites/mur/mur1.xpm
SO ./sprites/mur/mur1.xpm
WE ./sprites/mur/mur1.xpm
EA ./sprites/mur/mur1.xpm

F ./sprites/sol/sol13.xpm
C ./sprites/sol/sol13.xpm

                            1111111111111                       
     111111                 10000n0000001                       
     10n0m1      1111111111110000000000011111                   
     1000n01     10n00000000100000n0000010001                   
     10n0001     1000s00000020000000n00020n01                   
     1000001     10000000n001000n0000000100m1                   
     11111211111 10n01111111100000n0000011111                   
     10n00000001 10001      100n00000n001                       
     100s0000001110n0111     111112111111                       
     100000000010n000001        10001                           
     1000000000000000001        10001                           
     10000000001000000s1        10001                           
1111110000000n0111111111        10001                           
1000110000000001                10001                           
10n011111101111            111111000111                         
10001   10001              100200000001                         
11211   10001              100111000111                         
1000111110001              1n01110001                           
1000100010001              10n1110001                           
100020n010001              1111110001                           
1000100010001                   10001                           
1000111111011111                11211                1111111111
100011000000n001          111111000001111111         1000000001
1000110000000n01          100n000000000n0011         10s0000001
10001100000n0001          1000000000000000111111111111000n00001
10000100n0000001          1000000000n00000010000000001000000001
100002000000m001          10s0n00000000000000000n0000200000n001
1000010000000s01          100000n00000n000010000000s01000000001
1000110000000001          1000000000000n00111100001111000n00001
1000110000000001          100n00000000000011111001   1000000001
10001100n0000001          11111100000111111   1001   100000n0m1
1000111111211111               111211         1001   1111111111
1000111110001                   10001         1001             
1000111110001                   10001         1001             
1000100m10001                   10001         100111111111111  
100020n010001                   10001         100010n0000s001  
1000100010001                   10001         100020000n00001  
1000111110001                   10001         10001000s0000n1  
1000111110001111111111111       10001         111111111111111
100000000000000001000000111     10001
100000000000000000000000W01     10m01
100000000000000001000000111     10001
1111111111111111112111111       10001
          110s1002001      111111121111111
         110n0100101       1m00000000000m1
          110000011        100000000000001
            121111         100000000000001
            1001           100000000000001
            10n1           100000000000001
            1111           100000000000001
                           100000000000001
                           100000000000001
                           1000000b0000001
                           100000000000001
                           1m00000000000m1
                           111111111111111

