NO ./sprites/mur/mur3.xpm
SO ./sprites/mur/mur3.xpm
WE ./sprites/mur/mur3.xpm
EA ./sprites/mur/mur3.xpm

F ./sprites/sol/sol19.xpm
C ./sprites/sol/sol11.xpm

1111111111111111111111111111111111111
10n000000000000101m1010000000n00000m1
100n000n000000010000010n0000000000001
1000000000000002000002000000000000001
100000000000000100000100000000000n001
100n00000000000100000100000000n000001
1111111211111111000001111111121111111
      101      1000001      101      
1111111211111111000001111111121111111
1000n000000000010000010000000000m0001
1000000000000001000001000000000000001
10000000000000020000020000000000b0001
1000n000000n0001000001000000000000001
100n00000000000100N0010000000000n00m1
1111111111111111111111111111111111111
