NO ./sprites/mur/mur1.xpm
SO ./sprites/mur/mur2.xpm
WE ./sprites/mur/mur3.xpm
EA ./sprites/mur/mur4.xpm

F ./sprites/sol/sol5.xpm
C ./sprites/sol/sol12.xpm

                            1111111111111                       
     111111                 1000000000001                       
     100001      1111111111110000000000011111                   
     1000001     1000000000010000000000010001                   
     1000001     1000000000020000000000020001                   
	 1000001     1000000000010000000000010001                   
     11111211111 1000111111110000000000011111                   
     10000000001 10001      1000000000001                       
     1000000000111000111     111112111111                       
     1000000000100000001        10001                           
     1000000000000000001        10001                           
     1000000000100000001        10001                           
111111000000000111111111        10001                           
1000110000000001                10001                           
100011111101111            111111000111                         
10001   10001              100200000001                         
11211   10001              100111000111                         
1000111110001              1001110001                           
1000100010001              1001110001                           
1000000010001              1111110001                           
1000100010001                   10001                           
1000111111011111                11211                1111111111
1000110000000001          111111000001111111         1000000001
1000110000000001          100000000000000011         1000000001
1000110000000001          1000000000000000111111111111000000001
1000010000000001          1000000000000000010000000001000000001
1000020000000001          1000000000000000000000000002000000001
1000010000000001          1000000000000000010000000001000000001
1000110000000001          1000000000000000111100001111000000001
1000110000000001          100000000000000011111001   1
1000110000000001
1000111111211111