NO ./sprites/mur/mur1.xpm
SO ./sprites/mur/mur2.xpm
WE ./sprites/mur/mur3.xpm
EA ./sprites/mur/mur4.xpm

F ./sprites/sol/sol5.xpm
C ./sprites/sol/sol12.xpm

1111111111111111111111111111111111111
1000000000000001010101000000000000001
1000000000000001000001000000000000001
1000000000000002000002000000000000001
100000000000000100b001000000000000001
1000000000000001000001000000000000001
1111111211111111000001111111121111111
      101      1000001      101      
1111111211111111000001111111121111111
10000000000000010000m1000000000000001
1000000000000001000001000000000000001
1000000000000002000002000000000000001
1000000000000001000001000000000000001
100000000000000100N001000000000000001
1111111111111111111111111111111111111
