NO ./sprites/mur/mur1.xpm
SO ./sprites/mur/mur2.xpm
WE ./sprites/mur/mur3.xpm
EA ./sprites/mur/mur4.xpm

F ./sprites/sol/sol5.xpm
C ./sprites/sol/sol12.xpm

1111111111111111111111111111111111111
1000000000000001010101000000000000001
10000n0000000001000001000000000000n01
1000000000000002000002000000000000001
1000n0000000000100000100000000000n001
100n0000000000010000010000000000000n1
1111111211111111000001111111121111111
      101      1000001      101      
1111111211111111000001111111121111111
10000000000000010000010000n000000n001
1000000n000n0001000001000000000000001
100000000n000002000002000000000000001
10000000000000010000010000000n000n001
1000000n0000000100N001000000000000001
1111111111111111111111111111111111111
