
NO ./sprites/mur/mur1.xpm
SO ./sprites/mur/mur1.xpm
WE ./sprites/mur/mur1.xpm
EA ./sprites/mur/mur1.xpm

F ./sprites/sol/sol13.xpm
C ./sprites/sol/sol13.xpm


      111
      1b1
      101
      101
1111111211111111111111111111111111111
1m000000000000m101m1010000000n0000s01
10000000011100010000010n0000000000001
100000000000000200b002000000000000001
111111000000000100000100000000000n001
10010000000000010000010n0000000000001
112100000001111100000100000000000n001
100000100000000100000100000000000n001
1m000000000000m100000100000000n0000s1
1111111211111111000001111111121111111
      101      1000001      101      
1111111211111111000001111111121111111
1000000000000001000001000000000000001
100n000000000n0100000100000n000000001
1000000000000002000002000000000000001
100000000000000100000100000n000000001
10s0000000000001000001n0000n000000001
10000000000n00010000010000000000000s1
100000000000000100N0010000000000n0001
1111111111111111111111111111111111111

