NO ./sprites/mur/mur1.xpm
SO ./sprites/mur/mur2.xpm
WE ./sprites/mur/mur3.xpm
EA ./sprites/mur/mur4.xpm

F ./sprites/sol/sol5.xpm
C ./sprites/sol/sol12.xpm

1111111
1010101
100s001
1000001
1000001
1000001
1000001
1000001
1000001
1000001
1000001
1000001
1000001
1m0N0m1
1111111
