NO ./sprites/mur/mur3.xpm
SO ./sprites/mur/mur3.xpm
WE ./sprites/mur/mur3.xpm
EA ./sprites/mur/mur3.xpm

F ./sprites/sol/sol19.xpm
C ./sprites/sol/sol11.xpm

                                         11111
                                         1mn0111111111
11111111111111111                        100000000s001
10s0000000000000111111111111111111111111110n00n00n00n1
10n00000n00000n0200000n00000000000n0000002000000s00001
100000000000000011111111111111111001111111111111211111
1000n000n000n0001               1001           101
10000000000000001               1001           101111111111111111
10n0n0n0N0n0n0n01               1001           10000s000000000001
10000000000000s01           111110011111       111111111111111101
1000n000n00n00001           100000000001                      101
10000000000000001           100000000001                      101
10n00000n0000n001111111111111000n00n00011111111111111111111111101
1000000000s0000020000000000000000ss0000000000000000000000000000n1
11111011111111111111111111111000n00n00011111111111111111111111101
    101                     100000000001                      1s1
11111211111111111           1m0000000001                      101
1s0000000000000m1           111110011111                      101
10n00000n00000n01               1001                          101
10000000000000001111111111111111100111111111111111111111111111101
1000n000n000n0002000000000000000s0000000000000000000000n000000001
10000000000000001111111111111111111111111111111111111111111111111
10n0n0n000n0n0n01
10000000000000001
1000n000n00n00001
10000000000000001
10n00000n0000ns01
10000s00000000001
11111111111111111
