NO ./sprites/mur/mur2.xpm
SO ./sprites/mur/mur2.xpm
WE ./sprites/mur/mur2.xpm
EA ./sprites/mur/mur2.xpm

F ./sprites/sol/sol20.xpm
C ./sprites/sol/sol12.xpm

                                                        111111
                                                        110n0111111111
                11111111111111111                       11000000000m01
                1000000000000000111111111111111111111111110n00n00n00n1
                10n000m0n00000n000000000000000000000000000000000000001
                100000000000000011111111111111111001111111111111011111
                1000n000n000n0001               1001           101
                10000000000000001               1001           101111111111111111
                10n0n0n000n0n0n01               1001           100000000000000001
                10000000000000001           111110011111       111111111111111101
                1000n000n00n00001           10m000000001                      101
                10000000000000001           100000000001                      101
                10n00000n0000n001111111111111000n00n00011111111111111111111111101
                10000000000000000000000000000000000000000000000000000000000000001
                11111011111111111111111111111000n00n00011111111111111111111111101
                    101                     100000000001                      101
                11111011111111111           100000000001                      101
                10000000000000001           111110011111                      101
                10n00000n00000n01               1001                          101
                10000000000000001111111111111111100111111111111111111111111111101
                1000n000n000n0000000000000000000000000000000000000000000000000001
                10000000000000001111111111111111111111111111111111111111111111111
                10n0n0n000n0n0n01
                10000000000000001
                1000n000n00n00001
                10000000000000001
                10n00000n0000n001111111111111
                1m000000000000000000000000001
                11111111111111111111111111101
                                         11011
                                        11000111111111
11111111111111111                       11000000000001
1m00000000000000111111111111111111111111110n00n00n00n1
10n00000n00000n000000000000000000000000000000000000001
100000000000000011111111111111111101111111111111211111
1000n000n000n0001                101           101
10000000000000001                101           101111111111111111
10n0n0n000n0n0n01                121           100000s00000000001
10000000000000001           111110011111       1111111111111111n1
1000n000n00n00001           100000000001                      101
10000000000000001           100000000001                      101
10n00000n0000n001111111111111000n00n00011111111111111111111111101111111111111111111111111111111111111111111111111111111111111111111111111111111111111111111111111111111
1000000000000000000000000000200000000002000000000000000000000000n000000000n0000000000000000000n000000n0000000000n0000000000n00000000000000000000000000000000000000000W1
11111111111111111111111111111111111111111111111111111111111111111111111111111111111111111111111111111111111111111111111111111111111111111111111111111111111111111111111
