NO ./sprites/mur/mur1.xpm
SO ./sprites/mur/mur2.xpm
WE ./sprites/mur/mur3.xpm
EA ./sprites/mur/mur4.xpm

F ./sprites/sol/sol5.xpm
C ./sprites/sol/sol12.xpm

1111111111111111111111111111111111111
10n00000000000010101010000000n0000001
1000000n000000010000010n0000000000001
1000000000000002000002000000000000001
100000000000000100n00100000000000n001
100n00000000000100000100000000n000001
1111111211111111000001111111121111111
      101      1000001      101      
1111111211111111000001111111121111111
1000n00000000001000001000000000000001
100000000000000100000100000n000000001
1000000000000002000002000000000000001
10000000000n0001000001000000000000001
100n00000000000100N0010000000000n0001
1111111111111111111111111111111111111