
NO ./sprites/mur/mur1.xpm
SO ./sprites/mur/mur2.xpm
WE ./sprites/mur/mur3.xpm
EA ./sprites/mur/mur4.xpm

F ./sprites/sol/sol5.xpm
C ./sprites/sol/sol12.xpm

        1111111111111111111111111
        100000000011000000000001
        1011000012110000n00W0001
        100100000000000001110001
11111111101100000111000001 10001
100000000011000001110113111111111
11110111111111011100000010001
11110111111111011101010010001
11000000110101011100000010001
10000000000000002000000010001
10000000000000001101010000001
1100000111010101111101111000111
11110111 1110101 101111010001
11111111 1111111 111111111111
